NO ./img/text_rock.xpm
SO ./img/crane.xpm
WE ./img/dirt.xpm
EA ./img/wood.xpm
F0,0,50
C 50,0,0


        1111111111111111111111111
        1000000000110000000000001
        1011000001110000000000001
        10010000000D0000000000001
111111111011000001110000000000001
10000000001100000111D1111D1111111
11110111111111D11100000010001
11110111111111011101010010001
11000000110101011100000010001
10000000000000000D000000D0001
10000000000000001101010010001
1100000111011011111011110S0111
11110111 1110101 101111010001
11111111 1111111 111111111111