NO ./img/text_rock.xpm
SO ./img/crane.xpm
WE ./img/earth.xpm
EA ./img/wood.xpm
F 0,50,50
C 50,50,0


111111111
100000001
1011D1101
101000101
10D0S0D01
101000101
1011D1101
100000001
111011111
100000001
101101101
101000101
100000D01
101000101
1011D1101
100000001
111111111