NO ./img/text_rock.xpm
SO ./img/crane.xpm
WE ./img/earth.xpm
EA ./img/wood.xpm
F 0,50,50
C 50,50,0


11111111111
10010000001
10010000001
10010000001
10000000001
1N000000001
11111111111
