NO ./img/text_rock.xpm
SO ./img/crane.xpm
WE ./img/earth.xpm
EA ./img/wood.xpm
F 220,0,0
C 250,30,0


11111111111
10010000001
10010000001
10010000001
100000N0001
10000000001
11111111111
